O----------------------O
|P   O   O   O   O   W |
|    X     O   O   O   |
|K   O-----------O  C  |
|   O            |   V |
O---O  O------O  O-OPO-O
| D |  |    P    |P   P|
|H  |  |    P    |     |
|   O  |  O------O     |
|   P  |               |
O------O---------------O