O-----O--O----O--O-----O
|W   P|P O----O P|P   C|
|     O          O     |
|P                    P|
O---O     O  O     O---O
|K     O   PP   O     H|
O---O     O  O     O---O
|P                    P|
|     O O      O O     |
|X   P|P O----O P|P V D|
O-----O--O----O--O-----O