O-----------O--------O-O
|H          |        |P|
| O-O   O   O---O    | |
| | |   O            | |
| O-O    O--O        O |
|     P   WX    P      |
| O      O--O     O-O  |
| |          O    | |  |
| |  O---O   O    O-O  |
|P|      |            D|
O-O------O-------------O
