W----------------------C
|OP  O   O   O   O    O|
|      O   O   O   O   |
|K   O-----------O     |
|   O      P     |     |
O---O  O------O  O-OPO-O
| D |  |    P    |P   P|
|H  |  |    P    |     |
|   O  |  O------O     |
|O  P  |       P      O|
X------O---------------V