O-------------O------O-O
|H            |K    X|P|
| O-O    O    O---O  | |
| | |    O           | |
| O-O     O--O       O |
|     P    W     P     |
| O       O--O     O-O |
| |           O    | | |
| |  O---O    O    O-O |
|P|     P|            D|
O-O------O-------------O