O----------------------O
|P                    P|
|          WK          |
|                      |
|  O----------------O  |
|O                    O|
| O------O    O------O |
|P        O  O        P|
|PP       |  |       PP|
|PPP      |DH|      PPP|
O---------O--O---------O