O---O-----O--O-----O---O
|P  O    OWXCWO    O  P|
O--O                O--O
|                      |
O--O O----O  O----O O--O
|P         KP         P|
O  O---O  O--O  O---O  O
|                      |
| O-------O--O-------O |
|D|   O   |  |   O   |H|
O-O-------O--O-------O-O